NO ./sprites/north.xpm
SO ./sprites/south.xpm
WE ./sprites/west.xpm
EA ./sprites/east.xpm

F 46,139,87

C 135,206,235




1111111111111111111111111
1000000000110010000000001
101100000111000001000001
10010000000000S0100000001
1111111110000000101100001
10000000001100010111001111111
10000000001111011100000010001
11110111111111011101010010001
11000000110101011100000000001
10000000000000001100000010001
10000000000000001101010010001
11000001110101011111011110001
11110111 1110101 101111010001
    1     11111          111
